-1
-1
19
-1
01ff,02ff,02ff,02ff,02ff,02ff,02ff,02ff,02ff,03ff
04ff,05ff,05ff,15ff,05ff,05ff,15ff,05ff,05ff,11dd
04ff,05ff,05ff,15ff,05ff,05ff,15ff,05ff,05ff,06ff
04ff,05ff,05ff,05ff,05ff,05ff,05ff,05ff,05ff,06ff
04ff,05ff,15ff,15ff,15ff,15ff,15ff,15ff,05ff,06ff
07ff,08ff,08ff,08ff,08ff,08ff,08ff,08ff,08ff,09ff