2
40
29
56
15ff,15ff,15ff,15ff,15ff,15ff,15ff,15ff,15ff,15ff
15ff,05ff,05ff,15ff,05ff,05ff,05ff,15ff,05ff,15ff
15ff,15ff,05ff,15ff,05ff,15ff,05ff,15ff,05ff,11dd
15ff,15ff,05ff,15ff,05ff,15ff,05ff,15ff,05ff,15ff
15ff,15ff,05ff,05ff,05ff,15ff,05ff,05ff,05ff,15ff
15ff,15ff,15ff,15ff,15ff,15ff,15ff,15ff,15ff,15ff

