-1
10
-1
-1
15ff,15ff,15ff,15ff,15ff,15ff,15ff,15ff,15ff,15ff
13dd,05ff,05ff,05ff,05ff,05ff,05ff,05ff,05ff,15ff
15ff,15ff,15ff,15ff,05ff,05ff,15ff,15ff,15ff,15ff
15ff,05ff,05ff,05ff,05ff,05ff,05ff,05ff,05ff,15ff
15ff,05ff,05c2,05ff,05ff,05ff,05ff,05c1,05ff,15ff
15ff,15ff,15ff,15ff,15ff,15ff,15ff,15ff,15ff,15ff