-1
20
-1
-1
15ff,15ff,15ff,15ff,15ff,15ff,15ff,15ff,15ff,15ff
04ff,05ff,05ff,05ff,05ff,05ff,05ff,05ff,05ff,15ff
13dd,05ff,05ff,05ff,05ff,05ff,05ff,05ff,05ff,15ff
15ff,05ff,05ff,05ff,05ff,05ff,05ff,05ff,05ff,15ff
15ff,05ff,05ff,15ff,05ff,05ff,15ff,05ff,05ff,15ff
15ff,08e2,08e2,15ff,08e2,08e2,15ff,08e2,08e2,15ff