2
40
19
56
15ff,15ff,10dd,15ff,15ff,15ff,15ff,15ff,15ff,15ff
15ff,05ff,05ff,05ff,05ff,05ff,05ff,05ff,05ff,11dd
15ff,05ff,05ff,05ff,05ff,05ff,05ff,05ff,05ff,15ff
15ff,05ff,05ff,05ff,05ff,05ff,05ff,05ff,05ff,15ff
13dd,05ff,05ff,05ff,05ff,05ff,05ff,05ff,05ff,15ff
15ff,15ff,15ff,15ff,15ff,15ff,12dd,15ff,15ff,15ff