-1
-1
29
-1
15ff,15ff,15ff,15ff,15ff,15ff,15ff,15ff,15ff,15ff
15ff,05c1,05ff,15ff,05ff,05ff,05ff,15ff,05ff,15ff
15ff,15ff,05ff,15ff,05ff,15ff,05ff,15ff,05ff,11dd
15ff,15ff,05ff,15ff,05ff,15ff,05ff,15ff,05ff,15ff
15ff,15ff,05ff,05ff,05ff,15ff,05ff,05ff,05ff,15ff
15ff,15ff,15ff,15ff,15ff,15ff,15ff,15ff,15ff,15ff