5
-1
-1
-1
15ff,15ff,15ff,15ff,15ff,10dd,15ff,15ff,15ff,15ff
15ff,05ff,05ff,05ff,05ff,05ff,05ff,05ff,05ff,15ff
15ff,05ff,15ff,15ff,05ff,05ff,15ff,15ff,05ff,15ff
15ff,05ff,15ff,15ff,05ff,05ff,15ff,15ff,05ff,15ff
15ff,05ff,05ff,05ff,05ff,05ff,05ff,05ff,05ff,15ff
15ff,15ff,15ff,15ff,15ff,15ff,15ff,15ff,15ff,15ff