-1
-1
-1
52
15ff,15ff,15ff,15ff,15ff,15ff,15ff,15ff,15ff,15ff
15ff,05ff,05ff,05ff,05ff,05ff,05ff,05ff,05ff,15ff
15ff,05ff,14ff,14ff,14ff,14ff,14ff,14ff,05ff,15ff
15ff,05ff,14ff,14ff,14ff,14ff,14ff,14ff,05ff,15ff
15ff,05ff,05ff,05ff,05ff,05ff,05ff,05ff,05ff,15ff
15ff,15ff,12dd,15ff,15ff,15ff,15ff,15ff,15ff,15ff