-1
-1
-1
55
15ff,15ff,15ff,15ff,15ff,15ff,15ff,15ff,15ff,15ff
15ff,05ff,05e2,05ff,05e2,05ff,05e2,05ff,05e2,15ff
15ff,05ff,15ff,05ff,15ff,05ff,15ff,05ff,15ff,15ff
04ff,05ff,05ff,05ff,05ff,05ff,05ff,05ff,05ff,06ff
04ff,05ff,05ff,05ff,05ff,05ff,05ff,05ff,05ff,06ff
07ff,08ff,08ff,08ff,08ff,12dd,08ff,08ff,08ff,09ff