-1
-1
-1
58
15ff,15ff,15ff,15ff,15ff,15ff,15ff,15ff,15ff,15ff
15ff,05e1,05ff,05ff,05e1,05ff,05ff,05e1,05ff,15ff
15ff,05ff,05ff,15ff,05ff,05ff,15ff,05ff,05ff,15ff
15ff,05ff,05ff,15ff,05ff,05ff,15ff,05ff,05ff,15ff
15ff,05ff,05ff,05ff,05ff,05ff,05ff,05ff,05ff,15ff
15ff,15ff,15ff,15ff,15ff,15ff,15ff,15ff,12dd,15ff