-1
-1
-1
51
15ff,15ff,02e1,15ff,02e1,15ff,02e1,15ff,02e1,15ff
15ff,14ff,05ff,14ff,05ff,14ff,05ff,14ff,05ff,15ff
15ff,14ff,05ff,14ff,05ff,14ff,05ff,14ff,05ff,15ff
15ff,05ff,05ff,05ff,05ff,05ff,05ff,05ff,05ff,15ff
15ff,05ff,05ff,05ff,05ff,05ff,05ff,05ff,05ff,15ff
15ff,12dd,15ff,15ff,15ff,15ff,15ff,15ff,15ff,15ff