-1
-1
-1
51
01ff,02ff,02ff,02ff,02ff,02ff,02ff,02ff,02ff,03e2
04ff,05ff,05ff,05ff,05ff,05ff,05ff,05ff,05ff,06ff
04ff,05ff,05ff,05ff,15ff,15ff,05ff,05ff,05ff,06e1
04ff,05ff,05ff,05ff,15ff,15ff,05ff,05ff,05ff,06ff
04ff,05ff,05ff,05ff,05ff,05ff,05ff,05ff,05ff,06ff
07ff,12dd,08ff,08ff,08ff,08ff,08ff,08ff,08ff,09e2